11111111111111111111111
10000000000100000000001
100000P0010000000000001
10000000000100000000001
11111111111111111111111