     F 20,100,0
                                        NO                                  textures/floor.xpm          
                WE                                      textures/floor.xpm
                            EA           textures/floor.xpm                                 
C 1,30,0



SO                     textures/floor.xpm


111111111111111111111111111
100000000001100000000000001
101100000111000000000000111
100100000000000000000000111
1111111110110000011100000001 
10000001 1001100001110111111111111
11110111111111011100000010001
11110111111111011101010010001
11000000110101011100000010001 
10000000000000001100000010001
10000000000000001101010010001
11000001110101011111011110N0111
11110111 1110101 101111010001
10111111111 1111111 11 1111111111
11
1
1
1               1                               1
1              1             1
11111111111111111111111111