     F 20,100,0
                       NO textures/floor.xpm 
                WE                                   textures/floor.xpm
                            EA           textures/floor.xpm                                 
C        22,3,0



SO                textures/floor.xpm


1111111111111111111111111
 1000000001100000000000001
10110000011100000000001111
100100000000000000000001111
1111111110110000011100000001 
10000001 1001100001110111111
11110111111111 01110000010001
11110111111111011101010010001
1100000011010101110000010001
100000000000000110000010001 1
100000000000W00011010101000111
110000011101010111110111101111
11110111 1110101 1011110101
10111111111 1111111  11111
11
1
1
1
11
101
 11
1