     F 20,100,0
          C 20,0,100

SO                textures/floor.xpm                 
WE                textures/floor.xpm          
NO                textures/floor.xpm            
EA                textures/floor.xpm      



111111
1000001
1000D01
100W101
1000101
111111