NO textures/floor.xpm 
WE textures/floor.xpm
EA textures/floor.xpm                                 
SO textures/floor.xpm

F 220,100,0
C 225,30,0

11111
10ND01
10011
11111